1111111111111111111111111111111111
101X1X1X1X1X1X1X1X1X1X1X1X1X1X1X11
1000C000C000C000C000C000C000C00001
1P000000000000000000000000000000E1
100C000C000C000C00C00C000C000C0001
10X1X1X1X1X1X1X1X1X1X1X1X1X1X1X1X1
1111111111111111111111111111111111