1111111111111111111
1C10000C000001C0011
101001111000C001111
1010001111100011111
1C100111110C0111111
1000111111110001111
10000001P10000E0C01
1111100111000111111
100C00000000000C001
1111111111111111111