NO ./textures/BR_NO.png
SO ./textures/BR_SO.png
WE ./textures/BR_WE.png
EA ./textures/BR_EA.png

F 170,245,143
C 152,206,235

1111111111111111111111111
1000000000110000000000001
1011000001110000000000001
100100000000000000000000111111111
111111111011000001110000000000001
100000000011000001110111111111111
11110111111111011100000010001
11110111111111011101010010001
11000000110101011100000000001
10000000000000001100000010001
10000000000000001101010010001
1100000111010101111101111000111
11110101 1110101 101111010N01	
11111111  1111111 111111111111