NO textures/imgs/wall1 - 256x256.png 
SO textures/imgs/wall2 - 256x256.png
WE textures/imgs/wall3 - 256x256.png
EA textures/imgs/wall4 - 256x256.png
F 175, 143, 133  
C 153, 204, 255



        1111111111111111111111111
        1000000000110000000000001 
        1011000001110000000000001
        1001000000000000000000001111111111111
        1111111111111011000001110000000000001
            100000000011000001110111100111111
            11110111111111011100000010001
            11110111111111011101010010001
            11000000110101011100000010001
            10000000000000001100000010001
 1111       10000000000000001101010010001
 1001       11000001110101011111011110N0111
 1001       11110111 1110101 101111010001
 1111       11110111 1111111 111111111011
               101                   101
               101                   101
               101                   101
               101                   101
               1011111111111111111111101
               1000000000000000000000001
               1111111111111111111111111