11111111111111111111111111111111111111111111111111111111111111
10000000P000000C000000000C000000000E00000000000000000000000001
11111111111111111111111111111111111111111111111111111111111111