111111111111111111111111
100C10C00000010100000001
1111111000C000C011111001
1P000000X1100000000000E1
100C00111100100111000001
100X000C000000XC0001X001
111111111111111111111111