111111111111111111111111
100C00C00X0010C000000001
1111111000C000C011111001
1P000000X1110000000000E1
100C00111100000111000001
1000X00C00000X0C0000X001
111111111111111111111111