111111111111111111111111
100C00C0000001X100000001
1111111000C000C011111001
1P000000X1100000000000E1
100C00111100100111000001
1000X00C0000X10C0001X001
111111111111111111111111