111111111111111
1P0000C000C0001
10000C0E0C00001
100000C000C0001
111111111111111