11111111111111111111111
1110000C000000C00000C01
1P000C00011100000000001
111000C0000C00000000001
1111111111111111110C111
111111111111111111C0001
10000000000000110000001
10000011000C00001100001
1C0000C0000110000000001
10001111111111111111111
100C1111111111111111111
100000000000000000C0001
11100001111000CCCCCC0E1
1C00000C0000000000C0001
11111111111111111111111