111111111111111111111111
100C01C00000010100000001
1111111000C000C011111001
1P00000001100000000000E1
100C00111100100111000001
1000000C0000000C00010001
111111111111111111111111