111111111111111111
1P00C00C0XC00C00E1
111111111111111111