111111111111111111
1P00C00C0PC00C00E1
111111111111111111